// This file isn't generated, but this comment is necessary to exclude it from StyleCop analysis.
// <auto-generated/>
//####################################################################################################################################################################
//####################################################################################################################################################################
//####################################################################################################################################################################
//####################################################################################################################################################################
//##############################WTTTTTW###############################################################################################################################
//#########WGGGGGGGGGGGGGGGGGGGGW     WGGGGGGGGGGGGGGGGG##############################################################################################################
//#########W                                           GGGGG########################W#################################################################################
//#########W                                               GGGGGG###################W#################################################################################
//#########W                                                    GGG#################W#################################################################################
//#########W                                                      GGGGGG############W#################################################################################
//#########W     WGGGGGGGGGGGGGW                                       GGGGGGGGGDDDDWGGGGGGGGGGGGGGGGGGGGGGGGGGGGGGGGGGGGGGGGGGGGGGGGGGGGGGGG#########################
//#########W     W#############W                                                    W                                 MM  Z                   ########################
//#########W     W#############W                                                    W                                 MM  Z                   ########################
//#########W     W#############W                                                    W                                 MM  Z                   ########################
//#########W     W#############W                                                    W                            S    MM  Z                   ########################
//#########W     W#############W                                                    W    WGGGGGGGGGGGGGGGGGGGGGGGGGGGGGGGGGGGGGGGGGGGGGGGGGGGG########################
//#########W     W#############W                                                    W    W############################################################################
//#########W     W#############W                                                    W    W############################################################################
//#########W     W#############WGGGGGGGGGGGGW                                            W############################################################################
//#########W     W##########################W                                            W############################################################################
//#########W     W##########################W                                            W############################################################################
//#########W     W#############WGGGGGGGGGGGGW                              GGGGGGGGGGGGGGW#########W##################################################################
//#########W     W#############W                                                                   W##################################################################
//#########W     W#############W                                                                   W##################################################################
//#########W     W#############W                                                                   W##################################################################
//#########W     W#############W                                                                   W##################################################################
//#########W     W#############W                                                                   W##################################################################
//#########W     W#############W                                                                   W##################################################################
//#########W     W#############W                         W     W                                   W##################################################################
//#########W     W#############W     P                  GW     WG         E                        W##################################################################
//#########W     W#############W                       GGW     WGGB                 B              W##################################################################
//#########W     W#############WGGGGGGGGGGGGGGGGGGGGGGGGGW     WGGGGGGGGGGGGGGGGGGGGGGGGGGGGGW     W##################################################################
//#########W     W#######################################W     W#############################W     W##################################################################
//#########W     W#######################################W     W#############################W     W##################################################################
//#########W     W#######################################W     W#############################W     W##################################################################
//#########W     W#######################################W     W#############################W     W##################################################################
//#########W     W#######################################W     W#############################W     W##################################################################
//#########W     W#######################################W11111W#############################W     W##################################################################
//#########W     W#######################################WGGGGGW#############################W     W##################################################################
//#########W     WGGGGGGGGGGGGGGGGGGGGGGGGGGGGGGGGGGGGGGGGGGGGGGGGGGGGGGGGGGGGGGGGGGGGGGGGGGGW     W##################################################################
//#########W                                                             MM                        W##################################################################
//#########W                                             FFFF            MM                        W##################################################################
//#########W    G                                                     S  MM  S                     W##################################################################
//#########WUUUUGGGGGGGGGGGGGGGGGGGGGGGGGGGGGGGGGGGGGGGGGGGGGGGGGGGGGGGGGGGGGGGGGGGGGGGGGGGGGGGGGGGW##################################################################
//####################################################################################################################################################################
//####################################################################################################################################################################
//####################################################################################################################################################################
//####################################################################################################################################################################
//####################################################################################################################################################################
//####################################################################################################################################################################

